TILEMAP
104 7 							-- Size of tile map in tiles
32 32 							-- Tile size & block size
images/level1.png 	-- Tilesheet
8 8 								-- Number of tiles in tilesheet
44,43,44,48,49,50,51,52,44,43,48,49,50,49,50,49,50,49,50,51,52,35,44,35,44,43,35,44,43,43,35,44,35,35,35,43,44,35,43,48,51,52,43,4,5,5,5,5,5,5,5,5,5,5,5,5,5,5,5,5,5,5,5,5,5,5,5,5,5,5,5,5,5,5,5,5,5,5,5,5,5,6,6,6,6,6,6,6,6,6,6,6,6,6,6,6,6,6,6,7,35,35,35,35
43,35,35,56,57,58,59,60,35,35,56,57,58,57,58,57,58,57,58,59,60,44,43,35,35,35,44,43,44,44,35,35,43,43,35,44,35,35,35,56,59,60,44,13,13,13,13,13,13,13,13,13,13,13,13,13,13,13,13,12,12,12,12,12,13,13,13,13,13,12,12,12,12,12,12,12,12,12,13,13,12,14,15,15,15,15,15,15,15,15,15,15,15,15,15,15,15,15,15,15,29,30,23,39
35,20,21,22,20,22,20,20,21,21,21,22,20,21,21,22,22,20,21,21,20,21,21,22,35,43,35,35,20,21,21,21,22,35,35,35,35,20,21,21,21,21,22,3,3,3,3,3,3,3,3,3,3,3,3,3,3,3,3,13,13,13,13,13,3,3,3,3,3,12,13,13,12,12,12,12,12,13,3,3,12,13,13,12,12,12,12,12,12,12,12,12,12,12,13,13,13,13,12,12,37,38,31,47
35,3,3,3,3,3,3,3,3,3,3,3,3,3,3,3,3,3,3,3,3,3,3,3,40,41,41,42,3,3,3,3,3,40,41,41,42,3,3,3,3,3,3,3,3,11,11,11,11,11,11,11,11,11,11,11,11,11,3,3,3,3,3,3,3,11,11,11,11,13,3,3,12,13,13,12,12,3,3,11,12,3,3,13,13,13,13,12,12,12,12,12,13,13,3,3,3,3,13,12,45,46,31,47
9,11,11,11,11,3,3,3,11,11,11,11,11,3,3,11,11,11,11,11,19,19,19,11,9,9,9,9,11,11,11,11,11,9,9,9,9,11,11,11,11,11,11,11,11,11,11,19,19,11,3,3,3,3,3,3,3,11,11,11,11,11,11,11,11,11,19,11,3,3,3,11,12,3,3,13,13,11,11,19,12,11,3,3,3,3,3,12,12,13,13,12,3,3,11,19,19,19,3,13,53,54,27,28
10,25,25,25,26,11,11,11,3,11,11,3,32,11,11,24,25,26,11,11,11,11,11,24,8,9,9,10,25,25,25,25,25,8,9,9,10,25,26,11,11,11,11,11,11,11,11,11,11,32,11,11,11,11,11,11,11,11,11,11,3,3,11,3,3,11,11,11,11,11,11,11,12,11,3,3,3,11,11,11,12,11,11,11,11,11,11,13,12,3,3,12,11,11,11,11,11,11,11,3,61,62,31,47
9,9,9,9,18,1,1,1,2,33,33,0,17,1,1,16,9,18,2,33,33,0,1,16,9,9,9,9,9,9,9,9,9,9,9,9,9,9,18,1,1,1,1,2,33,33,33,0,1,17,1,1,1,2,33,34,3,3,3,3,11,11,11,11,11,11,11,11,11,11,11,11,12,3,11,11,11,11,3,11,12,11,11,11,11,3,3,3,12,11,11,12,11,11,3,3,3,3,3,3,3,55,63,47

3 6,33 6,40 6,41 6,42 6,55 6,19 22,.
